...################################################################################################
...##S........................................###############################....##################
#.###.........................................###############################....##################
############################################..###############################....##################
##...............................................############################....##################
########.......................................##############################....##################
########..####################################################################..###################
########..###################################################...............................#######
########..###################################################....#..........................#######
########....................#################################....######################...#########
#########################......##############################...#######################...#########
############################..###############################..#######################...##########
############################..###############################..######################...###########
############################..#######################..................###############...##########
############################..#######################..................################...#########
############################..#######################..################################...#########
############################...........................#################################...########
############################...........................############################################
#######################################...#########################################################
#######################################...#########################################################
######################################...##########################################################
####################################...############################################################
###################################...#############################################################
##################################...##############################################################
################################...################################################################
##########..............#########...###############################################################
#########..............#####...####################################################################
##########..............####..#####################################################################
#############................######################################################################
##############................#####################################################################
############################..###############################..######........................######
############################..#######################..................###############...##########
############################..#######################..................################...#########
############################..#######################..################################...#########
############################...........................#################################...########
############################...........................############################################
#######################################...#########################################################
#######################################...#########################################################
######################################...##########################################################
####################################...############################################################
###################################...#############################################################
##################################...##############################################################
################################...################################################################
###############################..................................................................##
#######################################.........................................................E##
###################################################################################################
